SO            gfx/wood.xpm      
          

          F     10,  12,           20

          EA gfx/banner.xpm   
  R 2000    12340000000000000000



                        NO               ./gfx/grey.xpm          
                                       WE                                  ./gfx/blue_brick3.xpm


                C       55,  25,  255                        

         

                            

S        gfx/barrel.xpm


111
111111
11N201
111111
111 
